Date,Start Time,End Time,Journey/Action,Charge,Credit,Balance,Note
22-Mar-2012,11:28,11:38,"Caledonian Road and Barnsbury to Kentish Town West",1.40,,3.45,""
20-Mar-2012,13:09,13:28,"Arnos Grove to Caledonian Road",1.40,,4.85,""
20-Mar-2012,12:56,,"Bus journey, route 232",1.35,,6.25,""
20-Mar-2012,11:29,,"Bus journey, route 263",1.35,,7.60,""
20-Mar-2012,10:37,,"Bus journey, route 17",1.35,,8.95,""
20-Mar-2012,10:36,,"Topped up, Caledonian Road",,10.00,10.30,""